0;0;0;0;1;2;9;2;
0;1;2;2;4;9;9;2;
0;2;9;9;9;9;3;2;
1;3;9;6;5;5;5;9;
2;9;9;4;9;9;9;9;
4;9;3;4;9;4;3;2;
9;9;3;9;2;1;0;0;
2;2;3;9;2;0;0;0
